//MAP CONVERTED BY dmm2tgm.py THIS HEADER COMMENT PREVENTS RECONVERSION, DO NOT REMOVE
"a" = (
/turf/template_noop,
/area/shuttle/arrival)
"b" = (
/turf/closed/wall/mineral/titanium,
/area/shuttle/arrival)
"c" = (
/obj/machinery/door/airlock/titanium{
	name = "Arrivals Shuttle Airlock"
	},
/obj/effect/turf_decal/stripes/line{
	dir = 1
	},
/obj/effect/turf_decal/stripes/line,
/turf/open/floor/plasteel/dark,
/area/shuttle/arrival)
"e" = (
/turf/template_noop,
/area/template_noop)
"f" = (
/turf/open/floor/mineral/titanium/blue,
/area/shuttle/arrival)
"g" = (
/obj/machinery/requests_console{
	department = "Arrival shuttle";
	name = "Arrivals Shuttle console";
	pixel_y = 30
	},
/turf/open/floor/mineral/titanium/blue,
/area/shuttle/arrival)
"h" = (
/obj/structure/shuttle/engine/propulsion{
	dir = 8
	},
/turf/open/floor/plating/airless,
/area/shuttle/arrival)
"i" = (
/obj/structure/shuttle/engine/heater{
	dir = 8
	},
/turf/open/floor/plating/airless,
/area/shuttle/arrival)
"j" = (
/obj/structure/shuttle/engine/heater{
	dir = 4
	},
/turf/open/floor/plating/airless,
/area/shuttle/arrival)
"k" = (
/obj/structure/shuttle/engine/propulsion{
	dir = 4
	},
/turf/open/floor/plating/airless,
/area/shuttle/arrival)
"l" = (
/obj/machinery/light{
	dir = 1
	},
/turf/open/floor/mineral/titanium/blue,
/area/shuttle/arrival)
"m" = (
/obj/machinery/door/airlock/shuttle{
	name = "Arrival Shuttle Airlock"
	},
/turf/open/floor/mineral/titanium,
/area/shuttle/arrival)
"o" = (
/obj/structure/closet/wardrobe/green,
/turf/open/floor/mineral/titanium,
/area/shuttle/arrival)
"p" = (
/obj/machinery/computer/arcade,
/obj/machinery/light{
	dir = 1
	},
/turf/open/floor/mineral/titanium,
/area/shuttle/arrival)
"q" = (
/obj/structure/chair/comfy/shuttle{
	dir = 8
	},
/obj/structure/window{
	dir = 4
	},
/turf/open/floor/mineral/titanium,
/area/shuttle/arrival)
"r" = (
/obj/structure/chair/comfy/shuttle{
	dir = 4
	},
/obj/structure/window{
	dir = 8
	},
/turf/open/floor/mineral/titanium,
/area/shuttle/arrival)
"s" = (
/obj/structure/table,
/obj/item/paper_bin,
/obj/item/pen,
/obj/machinery/light/small{
	dir = 8
	},
/turf/open/floor/mineral/titanium,
/area/shuttle/arrival)
"t" = (
/obj/structure/window{
	dir = 4
	},
/obj/structure/chair/comfy/shuttle{
	dir = 8
	},
/turf/open/floor/mineral/titanium,
/area/shuttle/arrival)
"u" = (
/obj/effect/spawner/structure/window/shuttle,
/turf/open/floor/plating,
/area/shuttle/arrival)
"v" = (
/obj/docking_port/mobile/arrivals{
	dir = 4
	},
/turf/template_noop,
/area/template_noop)
"w" = (
/obj/structure/closet/wardrobe/black,
/turf/open/floor/mineral/titanium,
/area/shuttle/arrival)
"x" = (
/obj/structure/chair/office{
	dir = 4
	},
/turf/open/floor/mineral/titanium,
/area/shuttle/arrival)
"y" = (
/obj/machinery/computer{
	name = "Shuttle computer";
	dir = 8
	},
/turf/open/floor/mineral/titanium,
/area/shuttle/arrival)
"z" = (
/obj/machinery/light,
/turf/open/floor/mineral/titanium/blue,
/area/shuttle/arrival)
"A" = (
/obj/effect/spawner/structure/window/shuttle,
/turf/open/floor/plating/airless,
/area/shuttle/arrival)
"B" = (
/obj/machinery/door/airlock/titanium{
	name = "Arrivals Shuttle Airlock"
	},
/obj/effect/turf_decal/stripes/line,
/obj/effect/turf_decal/stripes/line{
	dir = 1
	},
/turf/open/floor/plasteel/dark,
/area/shuttle/arrival)
"I" = (
/obj/structure/closet/wardrobe/mixed,
/turf/open/floor/mineral/titanium,
/area/shuttle/arrival)
"S" = (
/turf/open/floor/mineral/titanium,
/area/shuttle/arrival)
"T" = (
/obj/structure/closet/emcloset,
/obj/machinery/light/small{
	dir = 8
	},
/turf/open/floor/mineral/titanium,
/area/shuttle/arrival)
"W" = (
/obj/structure/table,
/obj/item/storage/firstaid/regular,
/obj/machinery/light,
/turf/open/floor/mineral/titanium,
/area/shuttle/arrival)

(1,1,1) = {"
a
h
b
v
b
h
a
"}
(2,1,1) = {"
b
i
b
A
b
i
b
"}
(3,1,1) = {"
b
b
b
w
b
b
b
"}
(4,1,1) = {"
e
b
o
S
I
b
e
"}
(5,1,1) = {"
b
b
p
S
W
b
b
"}
(6,1,1) = {"
c
f
f
f
f
f
B
"}
(7,1,1) = {"
b
g
r
r
r
f
b
"}
(8,1,1) = {"
A
f
S
S
S
f
A
"}
(9,1,1) = {"
A
f
q
q
q
f
A
"}
(10,1,1) = {"
A
f
r
r
r
f
A
"}
(11,1,1) = {"
A
f
S
S
S
f
A
"}
(12,1,1) = {"
b
l
t
t
t
z
b
"}
(13,1,1) = {"
c
f
f
f
f
f
B
"}
(14,1,1) = {"
b
b
b
m
b
b
b
"}
(15,1,1) = {"
e
A
s
S
T
A
e
"}
(16,1,1) = {"
b
b
b
x
b
b
b
"}
(17,1,1) = {"
b
j
u
y
u
j
b
"}
(18,1,1) = {"
a
k
u
u
u
k
a
"}
